11111111111111111111111111111111111111111
11PC11E1111111111111111111111111111111111
11111111111111111111111111111111111111111
