11111111
1P0E1111
11111111
11C11111
11111111
