NO ./assets/texture/NO.xpm
SO ./assets/texture/SO.xpm
WE ./assets/texture/WE.xpm
EA ./assets/texture/EA.xpm

F 220,100,0
C 225,30,0

11111 111
10001 101
10S01 111
10001
11111
