NO ./assets/texture/NO.xpm
SO ./assets/texture/SO.xpm
WE ./assets/texture/WE.xpm
EA ./assets/texture/EA.xpm

F 220,100,0
C 225,30,0

11111
10001
10S01   1111
10001   1001
11111   1111
