NO ./assets/texture/NO.xpm
SO ./assets/texture/SO.xpm
WE ./assets/texture/WE.xpm
EA ./assets/texture/EA.xpm

F 220,100,0
C 225,30,0

    1   1   1   1   1   1   1
 11   1       1   1   1
 11 1   11111   1   1   1 111
      1 10001 1   1   1   101
1   1   10S01   1   1   1 111
  1   1 10001 1   1   1
1   1   11111   1   1   1   1
  1           1   1   1   1
1   1 111   1    111    1   1
  1   111 1   1   1   1   1
