NO ./assets/texture/NO.xpm
SO ./assets/texture/SO.xpm
WE ./assets/texture/WE.xpm
EA ./assets/texture/EA.xpm

C 19,50,48
F 72,36,19

        1111111111111111111111111
        10000000000000000000000011111111111111
        10110000000000000000000000000000000001
        10010000000000000000000011111111111111  111
111111111011000000000000000000001               101
100000000000000000000111111111111               101
10000000000000000000000010001                   101
10000000000000000001010010001                   101
10000000000000000000000010001                   101
10000000000000000000000010101                   101
10000000N00000000010100100011111111111111111111110111111
11000001110000011100000000000000000000000000000000000001
10000001 1000001 100000000001111111111111111111111111111
11111111 1111111 111111111111
