NO ./path_to_the_north_texture
SO ./path_to_the_north_texture
WE ./path_to_the_north_texture
EA ./path_to_the_north_texture

F 220, 100, 0
C 225, 30, 0

1111111111111111111111111
1000000000110000000000001
1011000001110000000000001
1001000000000000000000001
111111111011000001110000000000001
100000000011000001110111111111111
11110111111111011100011111111
00000000111111111110000001001
01010101011001010101010100101
1001N101000000000000000000001
11111111111111111111111111111
00011 01001010101010 01010101
01010 10101001010101 10010101
